00000000000000000000
00000000000000000000
00000011100000111110
00000000000000000000
11100000000000000000
00000000111000011111
00000000000000000000
00100000000000000000
00000000000000111110
00000000000000000000